xxxxxxxxxxxxxxxxxxxx
        x        sxx
 x   x s           x
     x    sxs   x  x
 s  x  xx xt x  x  s
       xb x      x
   s   sxxx  s
x  x            xsx
 s x   xs    x  xmx
xxxxxxxxxxxxxxxxxxxx