xxxxxxxxxxxxxxxxxxxx
x    m   s      x  m
        b  s  s  s x
 x     xsx     x   x
    s       x s  s t
s      s  x        x
 x     x       s  sx
   xs  b s  s     bx
xm   s   x xsss    x
xxxxxxxxxxxxxxxxxxxx