xxxxxxxxxxxxxxxxxxxx
x    ms         x  x
        b  s  s  smx
 x     xsx     x   x
    s       x s  s t
       s  x        x
 x     x       s  sx
  sxs  b s  s     bx
xm       x xsss    x
xxxxxxxxxxxxxxxxxxxx